- - - - - - - - - -
1 - 1 2 2 2 2 1 - 1
- 1 - 4 2 2 4 - 1 -
- 3 1 - 1 1 - 1 3 -
- - - 3 4 4 3 - - -
- 3 5 4 1 1 4 5 3 -
- 2 1 - - - - 1 2 -
4 1 - - - - - - 1 4
1 - - P - - - - - 1
1 - - - - - - - - 1