2 - - - M - - - - 2
3 2 - - - - - - 2 3
1 3 2 - - - - 2 3 1
1 1 3 2 - - 2 3 1 1
1 3 2 - - - - 2 3 1
3 2 - - 4 4 - - 2 3
2 - - 4 5 5 4 - - 2
- - 3 5 1 1 5 3 - -
- 1 5 1 - - 1 5 1 -
1 5 1 - - - - 1 5 1
5 1 - - 4 4 - - 1 5
1 - - 4 5 5 4 - - 1
- - 3 5 1 1 5 3 - -
- 1 5 1 - - 1 5 1 -
1 5 1 - - - - 1 5 1
5 1 - - - - - - 1 5
1 - - - - - - - - 1